#########
#o     o#
# #   # #
#   B   #
#  BPB  #
#   B   #
# #   # #
#o     o#
#########