#############
#  #     #o #
# B#  B B#oo#
# BPB # B oo#
#     # B oo#
#############