       ######
########oooo#
#     ##  Po#
# B B ##BB o#
## #     B o#
 # B B    Bo#
 #   ########
 #####