#######
#o   o#
# oB  #
# BPB #
#  B  #
#    o#
#######