####
#P ##
# B ##
#B   #######
#o# B B B o#
###    B  o#
  #   B   #
  #  ###  #
  #oo# #oo#
  #### ####